1111111111111111111111111111111
1000000000000000000000000000001
101000010000C000000010000010011
1111000010000000000010000100C01
110P0000000000000000000000001E1
1000000000000000000000000000001
1111111111111111111111111111111