1111111111
1000C11101
1P11100001
1000000001
11111111E1
1111111111