111111111111111111111111111111111111111111111111111111111111
1EP000000000000000000000000000000000000000000000000000000001
111111111111111111111111111111111111111111111111111111111101
100000000000000000000000000000000000000000000000000000000001
101111111111111111111111111111111111111111111111111111111111
100000000000000000000000000000000000000000000000000000000001
111111111111111111111111111111111111111111111111111111111101
100000000000000000000000000000000000000000000000000000000001
101111111111111111111111111111111111111111111111111111111111
100000000000000000000000000000000000000000000000000000000001
111111111111111111111111111111111111111111111111111111111101
100000000000000000000000000000000000000000000000000000000001
101111111111111111111111111111111111111111111111111111111111
100000000000000000000000000000000000000000000000000000000001
111111111111111111111111111111111111111111111111111111111101
100000000000000000000000000000000000000000000000000000000001
101111111111111111111111111111111111111111111111111111111111
100000000000000000000000000C00000000000000000000000000000001
111111111111111111111111111111111111111111111111111111111101
100000000000000000000000000000000000000000000000000000000001
101111111111111111111111111111111111111111111111111111111111
100000000000000000000000000000000000000000000000000000000001
111111111111111111111111111111111111111111111111111111111101
100000000000000000000000000000000000000000000000000000000001
101111111111111111111111111111111111111111111111111111111111
100000000000000000000000000000000000000000000000000000000001
111111111111111111111111111111111111111111111111111111111101
100000000000000000000000000000000000000000000000000000000001
101111111111111111111111111111111111111111111111111111111111
100000000000000000000000000000000000000000000000000000000001
111111111111111111111111111111111111111111111111111111111101
100000000000000000000000000000000000000000000000000000000001
101111111111111111111111111111111111111111111111111111111111
100000000000000000000000000000000000000000000000000000000001
111111111111111111111111111111111111111111111111111111111101
10000C000000000000000000000000000000000000000000000000000001
101111111111111111111111111111111111111111111111111111111111
100000000000000000000000000000000000000000000000000000000001
111111111111111111111111111111111111111111111111111111111101
100000000000000000000000000000000000000000000000000000000001
101111111111111111111111111111111111111111111111111111111111
100000000000000000000000000000000000000000000000000000000001
111111111111111111111111111111111111111111111111111111111101
100000000000000000000000000000000000000000000000000000000001
101111111111111111111111111111111111111111111111111111111111
100000000000000000000000000000000000000000000000000000000001
111111111111111111111111111111111111111111111111111111111101
10000000000000000000000000CCCCCCCCCCCCCCCCCCCCCCCCCCC0000001
101111111111111111111111111111111111111111111111111111111111
100000000000000000000000000000000000000000000000000000000001
111111111111111111111111111111111111111111111111111111111101
100000000000000000000000000000000000000000000000000000000001
101111111111111111111111111111111111111111111111111111111111
100000000000000000000000000000000000000000000000000000000001
111111111111111111111111111111111111111111111111111111111101
100000000000000000000000000000000000000000000000000000000001
101111111111111111111111111111111111111111111111111111111111
1010001000100010001000100010001000100010001000100010001CCCC1
1000100010001000100010001000100010001000100010001000100011C1
111111111111111111111111111111111111111111111111111111111111
