111111111111111111
111111111111111111
111111111111111111
111P00C00000P11111
111111111111111111
111111111111111111
111111111111111111
