111111111111
100PPCCCE001
111111111111
