11111111111111
10100000000001
111000000C0001
1000000P001111
10000000000E01
11111111111111