1111111
1C11101
1110001
1C00011
1P000E1
1111111