111111111111111111
1C11101
11100011111
1P000E1
1111111
