1111111111
100000PCE1
1111111111