1111111111
10P000CCE1
1111111111