1111111111
101000PCE1
1000000001
1000010001
1000000001
1000100001
1000000001
1000000001
1111111111