1111111111
101000C0E1
1000000001
1000010001
1000000001
1000100001
1000000001
10000P0001
1111111111